Визначився порядок виступів усіх 26 фіналістів у гранд-фіналі, який відбудеться вже цієї суботи, 13 травня.

Як повідомляє Укрінформ з посиланням на Eurovision Song Contest 2023, жеребкуванням було визначено порядок, згідно з яким учасники конкурсу виступлять у фіналі.
“Жеребкуванням було визначено, що Україна виступатиме під номером 19, а Велика Британія – під номером 26 у гранд-фіналі”, - йдеться у повідомленні.
Порядок виступів учасників фіналу Євробачення 2023:

Австрія: Teya & Salena – Who The Hell Is Edgar?
Португалія: Mimicat – Ai Coraçao
Швейцарія: Remo Forrer – Watergun
Польща: Blanka – Solo
Сербія: Luke Black – Samo Mi Se Spava
Франція: La Zarra – Évidemment;
Кіпр: Andrew Lambrou – Break A Broken Heart
Іспанія: Blanca Paloma – Eaea;
Швеція: Loreen – Tattoo
Албанія: Albina & Familja Kelmendi – Duje
Італія: Marco Mengoni – Due vite;
Естонія: Alika – Bridges
Фінляндія: Käärijä – Cha Cha Cha
Чехія: Vesna – My Sister's Crown
Австралія: Voyager – Promise
Бельгія: Gustaph – Because Of You
Вірменія: Brunette – Future Lover
Молдова: Pasha Parfeni – Soarele si Luna
Україна: TVORCHI – Heart Of Steel
Норвегія: Alessandra – Queen of Kings
Німеччина: Lord Of The Lost – Blood & Glitter;
Литва: Monika Linkyte – Stay
Ізраїль: Noa Kirel – Unicorn
Словенія: Joker Out – Carpe Diem
Хорватія: Let 3 – Mama ŠČ!
Велика Британія: Mae Muller – I Wrote A Song.

Як повідомляв Укрінформ, пісенний конкурс Євробачення-2023 проходить у Ліверпулі після того, як Україна, яка перемогла на конкурсі 2022 року з піснею Stefania гурту Kalush Orchestra, не змогла задовольнити вимоги щодо проведення конкурсу через безпекові побоювання, спричинені російським вторгненням.
Півфінали конкурсу відбулися 9 та 11 травня, фінал пройде 13 травня.
Україну на конкурсі представляє гурт TVORCHI з піснею Heart of Steel.
Фото: EBU